128 18 32 32
// The first line should contain the width and height of the
// map and the width and height of each tile. A list of character to
// tile mappings is then provided where each character is preceded by a
// # character. The dot character always defaults to a blank space 
// Note that the referenced files should be in the same directory as the
// tile map.
#p=pillar-body.png
#t=pillar-top.png
#b=pillar-bottom.png
#g=ground.png
// #1=floor_layer_1.png
// #2=floor_layer_2.png
// #3=floor_layer_3.png
#4=floor_layer_3.png
#1=DBUG.png
#2=DBUG.png
#3=DBUG.png
//
// The actual tile map is preceded by the #map line
#map
gggggggggggggggggggggggggggggggggggggggggggggggggggggggggggggggggggggggggggggggggggggggggggggggggggggggggggggggggggggggggggggggg
p....p.......p.......p.......p.......p.......p.......p.......p..p....p.......p.......p.......p.......p.......p.......p.......p..
p....p.......p.......p.......p.......p.......p.......p.......b..p....p.......p.......p.......p.......p.......p.......p.......b..
b....p.......p.......p.......b.......p.......p.......p..........b....p.......p.......p.......b.......p.......p.......p..........
.....b.......b.......p...............p.......b.......p...............b.......b.......p...............p.......b.......p..........
.....................p...............p...............p...............................p...............p...............p..........
.....................p...............p...............b...............................p...............p...............b..........
.....................b.......t.......p.......................t.......................b.......t.......p.......................t..
.............................p.......b.......t...............p...............................p.......b.......t...............p..
.............................p...............p...............p.......t........t..............p...............p...............p..
.............................p...............p.......t.......p.......p........p..............p...............p.......t.......p..
.............................p...............p.......p.......p.......p........p..............p...............p.......p.......p..
t....................t.......p.......t.......p.......p.......p..t....p........p......t.......p.......t.......p.......p.......p..
p.........11111......p.......p.......p.......p.......p.......p..p....p........p......p.......p.......p.......p.......p.......p..
p.........22222......p.......p.......p.......p.......p.......p..p....p........p......p.......p.......p.......p.......p.......p..
p.......3333333333...p.......p.......p.......p.......p.......p..p....p........p......p.......p.......p.......p.......p.......p..
p.......3333333333...p.......p.......p.......p.......p.......p..p....p........p......p.......p.......p.......p.......p.......p..
44444444444444444444444444444444444444444444444444444444444444444444444444444444444444444444444444444444444444444444444444444444