256 16 50 50
// The first line should contain the width and height of the
// map and the width and height of each tile. A list of character to
// tile mappings is then provided where each character is preceded by a
// # character. The dot character always defaults to a blank space 
// Note that the referenced files should be in the same directory as the
// tile map.
#p=pillar-body.png
#t=pillar-top.png
#b=pillar-bottom.png
#g=ground.png
// #1=floor_layer_1.png
// #2=floor_layer_2.png
// #3=floor_layer_3.png
#4=floor_layer_3.png
#1=DBUG.png
#2=DBUG.png
#3=DBUG.png
#k=key.png
#x=DBUG.png
//
// The actual tile map is preceded by the #map line
#map
bbbbbbbbbbbbbbbbbbbbbbbbbbbbbbbbbbbbbbbbbbbbbbbbbbbbbbbbbbbbbbbbbbbbbbbbbbbbbbbbbbbbbbbbbbbbbbbbbbbbbbbbbbbbbbbbbbbbbbbbbbbbbbbbbbbbbbbbbbbbbbbbbbbbbbbbbbbbbbbbbbbbbbbbbbbbbbbbbbbbbbbbbbbbbbbbbbbbbbbbbbbbbbbbbbbbbbbbbbbbbbbbbbbbbbbbbbbbbbbbbbbbbbbbbbbbbbbb
.....................p...............b...............b...............................p...............b...............b.............................................................33....33333..............3333.............33333333333333333333333333333333333
.....................b...............................................................b.............................................................................................33........................................33333333333333333333333333333333333
...................................................................................................................................................................................33........................................33333333333333333333333333333333333
...................................................................................................................................................................................33...................................33xxx33333333333333333333333333333333333
...................................................................................................................................................................................33...........33333333333333333333333333...33333333333333333333333333333333333
...................................................................................................................................................................................33.....33333333333333333333333333333333...33333333333333333333333333333333333
...................................................................................................................................................................................33........................33333......33...33333333333333333333333333333333333
.............................................t...............................................................t...............p...................333333333333......................33........................33333......33...33333333333333333333333333333333333
.............................t...............p...............t.......t.......................t...............p...............p...............2222222222222222......................33...................................33...33333333333333333333333333333333333
t....................t.......p.......t.......p.......p.......p..t....p........t..............p.......t.......p.......t.......p...............3.....................................3333333333333333333333...............33...33333333333333333333333333333333333
p.........11111......p.......p.......p.......p.......p.......p..p....p........p......t.......p.......p.......p.......p.......p...............3..........................................................................33...33333333333333333333333333333333333
p.........22222......p.......p.......p.......p.......p.......p..p....p........p......p.......p.......p.......p.......p.......p...............3..........................................................................33......................................
p.......3333333333...p.......p.......p.......p.......p.......p..p....p........p......p.......p.......p.......p.......p.......p...............3......t..t...........................................................3333333......................................
p.......3333333333...p.......p.......p.......p.......p.......p..p....p........p......p.......p.......p.......p.......p.......p...............33333333333333333.....................333333333333333333333333333333333333333......................................
4444444444444444444444444444444444444444444444444444444444444444444444444444444444444444444444444444444444444444444444444444444444444444444444444444444444444444444444444444444444444444444444444444444444444444444444444444444444444444444444444444444444444444