256 16 50 50
// The first line should contain the width and height of the
// map and the width and height of each tile. A list of character to
// tile mappings is then provided where each character is preceded by a
// # character. The dot character always defaults to a blank space
// Note that the referenced files should be in the same directory as the
// tile map.
#p=pillar-body.png
#t=pillar-top.png
#b=pillar-bottom.png
#g=ground.png
// #1=floor_layer_1.png
// #2=floor_layer_2.png
// #3=floor_layer_3.png
#4=floor_layer_3.png
#1=DBUG.png
#2=DBUG.png
#3=DBUG.png
#k=key.png
#5=floor_layer_2.png
#6=floor_layer_1.png
#x=DBUG.png
//
// The actual tile map is preceded by the #map line
#map
bbbbbbbbbb3333333333333333333333333333333333333333333333333333333333333333333333333333333333333333333333333333333333333333333333333333333333bbbbbbbbbbbbbbbbbbbbbbbbbbbbbbbbbbbbbbbbbbb3333333333333333333333333333333333333333333333333333333333333333333333333
.............33...............33.................................33......................................................................33............................................33.............................x.........................................
.............33...............33.................................33......................................................................33............................................33.............................x.........................................
.............33...............33.................................33.....................................................................333333..........................................33.............................x........................................
...............................................333.........33333333..........................333333333333333333333333333333333333333....333333..........................................33...333333333333333333333333333........................................
...............................................333.....................................333..........................................3....33............................................33.............................33........................................
...............................................333.....................................333..........................................3....33............................................33.............................333.......................................
..........33333333333333333333333333333333333333333333333333333333333333333333333333333333..........................................3....33............................................33.............................3333......................................
.........................................................................................333333333333333333333333333333333333333...33...333333.........................................3333333333333333333333333333...33333.....................................
....................................................................................................................................3...333333.........................................33.............................333333....................................
....................................................................................................................................3.................................................................................3333333...................................
.........t...............t............t.............................................................................................3.................................................................................33333333..................................
.........p...............p............p..................................................33333333333333333333333333333333333333333333.......................................................33333333333333333333333333333333333.................................
666666666666666666666666666666666666666666666666666666666666......................66666666666666666666666666666666666666666666666666666666666666666666666666......................6666666666666666666666666666666666666666666666................................
555555555555555555555555555555555555555555555555555555555555......................55555555555555555555555555555555555555555555555555555555555555555555555555......................55555555555555555555555555555555555555555555555...............................
4444444444444444444444444444444444444444444444444444444444444444444444444444444444444444444444444444444444444444444444444444444444444444444444444444444444444444444444444444444444444444444444444444444444444444444444444444444444444444444444444444444444444444